1111111111111111111111111111111111111111111111111111111111111111111111111111111111111111111111111111111111111111111111111
1P010010100000CP00E1110100101000000100E1110100101000000100E1110100101000000100E1110100101000000100E1110100101000000100E11
1001000000000000000110010000000001111101100100000000011111011001000000000111110110010000000001111101100100000000011111011
1001001010100100000110010010101001000001100100101010010000011001001010100100000110010010101001000001100100101010010000011
1000001010100100000111000001010100100000110000010101001000001110000010101001000001100000101010010000011100000101010010001
1000001111100101000110000011111001010001100000111110010100011000001111100101000110000011111001010001100000111110010100011
1111001000000101000111111001000000101000111111001000000101000111111001000000101000111111001000000101000111111001000000101
1000001000000101000110000010000001010001100000100000010100011000001000000101000110000010000001010001100000100000010100011
1000111000000001000110000111000000001000110000111000000001000110000111000000001000110000111000000001000110000111000000001
1000001000000001000110000010000000010001100000100000000100011000001000000001000110000010000000010001100000100000000100011
1111101000000100000111111010000001000001111110100000010000011111101000000100000111111010000001000001111110100000010000011
1000001110001101000110000011100011010001100000111000110100011000001110001101000110000011100011010001100000111000110100011
1011111000000101000111011111000000101000111011111000000101000111011111000000101000111011111000000101000111011111000000101
100000101111110100P11100000101111110100P11100000101111110100P11100000101111110100P111000001011111101000111000001011111101
1P0100101000000100E1110100101000000100E1110100101000000100E1110100101000000100E1110100101000000100E1110100101000000100E11
1001000000000111110110010000000001111101100100000000011111011001000000000111110110010000000001111101100100000000011111011
1001001010100100000110010010101001000001100100101010010000011001001010100100000110010010101001000001100100101010010000011
1000001010100100000111000001010100100000110000010101001000001110000010101001000001100000101010010000011100000101010010000
1000001111100101000110000011111001010001100000111110010100011000001111100101000110000011111001010001100000111110010100011
1111001000000101000111111001000000101000111111001000000101000111111001000000101000111111001000000101000111111001000000101
1000001000000101000110000010000001010001100000100000010100011000001000000101000110000010000001010001100000100000010100011
1000111000000001000110000111000000001000110000111000000001000110000111000000001000110000111000000001000110000111000000001
1000001000000001000110000010000000010001100000100000000100011000001000000001000110000010000000010001100000100000000100011
1111101000000100000111111010000001000001111110100000010000011111101000000100000111111010000001000001111110100000010000011
1000001110001101000110000011100011010001100000111000110100011000001110001101000110000011100011010001100000111000110100011
1011111000000101000111011111000000101000111011111000000101000111011111000000101000111011111000000101000111011111000000101
100000101111110100P11100000101111110100P11100000101111110100P111000001011111101000111000001011111101000111000001011111101
1111111111111111111111111111111111111111111111111111111111111111111111111111111111111111111111111111111111111111111111111
