11111111111111111111
1P010010100000C100E1
10010000000001111101
10010010101001000001
100000101C1001000001
10000C11111001010001
1111001C0000C1010001
10000010000001010001
100011100CC000010001
10000C10000000010001
1111101C0000C1000001
10000011100011010001
1011111C0000C1010001
10000C10111111010001
10000C00100000000001
10111110001111111111
1C0000000000000000C1
1C0000000C00000000C1
11111111111111111111
